14 20 246
####################
#    **        *** #
# *         * *  #*#
#   **     *    ## #
#  *    *   ### #  #
#  *       * #   I #
#   C   ###    !#  #
# #########  P# ## #
##*B* **###*  # *# #
# #####!### ###    #
# ## ##*###   #*## #
# #  #* ###*  # ## #
# >    *     *     #
####################
