15 30 351
##############################
#   *        #          *    #
# #   #  #    #       ### #  #
# ##P##*## #  ##I## #   # ## #
# #   #*#  ## ## ##*#   # *# #
#  *       *# *  *  #    **  #
#   #    #  #  *#     #  ### #
#  ># * ##  ### ## ## ##*# * #
# ##### #   ###  # ## @# #   #
# *    B    ###      C  * *  #
# # *###### ### ###### #  *#*#
# ## ######*### ###### # * # #
#  # ###### ### ###### # ### #
#    *  @  *  #              #
##############################
