17 19 278
###################
#          **     #
#   *    >     ##*#
#      *   * * ##*#
# ###  #    ## !**#
#     ## C*  ##*  #
# **#P#  ##  *    #
#*  #     ##   ## #
# #####* *    *## #
#     B ######    #
# # * * ######* # #
# #   * ###### ## #
# ###*# *    *I#* #
# #   #  ##  #    #
# #  !# ##  ###   #
#  *              #
###################
