11 16 161
################
#    C *      *#
#* ! *    *  # #
#    * B *   # #
#  *       ### #
#           *# #
#  # #      *# #
#*##*## ##*   *#
# #  *#  ##  P #
#  *   >   *  !#
################
