10 17 132
#################
#      #@ ** *  #
# *    ###*    *#
# * B  ### ###  #
#     ####*   * #
# # *  ### #   *#
# # ## ###P## C #
# # ##I###  #   #
#  >    @# *    #
#################
