20 15 266
###############
# *   *       #
#*## B** ##   #
#*## ## ##   *#
#    ##   *   #
#!##  *   #  >#
# ## ##*I##*  #
#     ## #    #
# ##*         #
#  ##*   !#   #
#   *   * #   #
#   # *P###   #
#   # * **#   #
# #####   #   #
#          ** #
#    #####   *#
# ##*  # * ## #
# ##! *# * ## #
#     * C*    #
###############
