19 17 257
#################
# >       *     #
#       *      *#
#    *     I#   #
# ##### ### ##  #
#   #    #***#  #
#*  # !   **    #
#        ###### #
# ###    ###### #
#   C    ###### #
# ######  *    *#
#*######*   ### #
# ###### #  ### #
#  *     #  ### #
# #     *#  ### #
# # *  B  * ### #
# # ### ###*### #
#        *  *   #
#################
