13 18 209
##################
#     *    **    #
#        *       #
#* *  !    P     #
#* *#####    #  *#
# *   #   ##*##  #
#I#*B*#   ##  #  #
# #**** * C *    #
#*### #   # #  # #
# #  *# ! # #>## #
# #  *### #*#* # #
#        *    *  #
##################
