16 19 261
###################
#  *    * *   *   #
# *     !* * *   *#
#     *    *      #
#* * *      ###   #
#   *I      ### # #
#  *    * * ### # #
# ######    ### # #
# ######  #*###   #
#*###### ##*### # #
#     *  # * >  # #
# **#    ! P# ### #
#   #* C ## # **B #
# ##### ##  ###   #
#    *           *#
###################
