20 14 233
##############
#   *   >    #
#    ## ##   #
# * *## ##   #
# ##   C     #
# ## ##  *#  #
#**  ##*  #  #
#! #    # #  #
# ###  *#  B #
#*    #####**#
#*###    *   #
#     * !##  #
#  #   #  ## #
# ##I *#*    #
#  # ### ### #
#       P #  #
# *#* ##     #
# ### ## ### #
#    *       #
##############
