15 20 276
####################
#*                *#
#  *     *  *      #
# ###   *      *   #
#     ###  C  *#   #
# ###* ##########* #
#      #  * B * ## #
# ###P## ##### **# #
# #    # #   #! ##*#
# #  * * #*  ##### #
#      #* **    #  #
# ### ##!###  #    #
# *#   #  #  ###   #
# >   *       *  * #
####################
