15 16 191
################
#     * ! *    #
# ### ** *###  #
#*#*   #  # * *#
# # I ### #    #
#       *    * #
#*###### ###P !#
# ######* *  * #
# ######   ##  #
#  >       ##  #
# #*  C  # * B*#
# ##*##  ## ## #
# # ! ## # *## #
# *         *  #
################
