15 20 261
####################
#    *  **         #
# *   *     ###* * #
#     #####*     # #
#   * * #   ### ##I#
#  P    #*   #   # #
#   #             *#
#@  ####  C ###### #
#####*####* ########
#  *   **######### #
# # > # # #      **#
#*## ## #*##       #
#  #  # # @#      *#
#*   *        B    #
####################
